111111111111111111111111111111111111
1P1E100000000000000000000000CCCCCCC1
101C11111111111000000010000000000001
101CCCCCCCCCCCC000000011111111111111
101111111111111000000000000000000001
100000000000000000000000000000000001
1000000CC000CCCCC000CCCCC000CCCCC001
100000C0C0000000C0000000C0000000C001
10000000C000CCCCC000CCCCC0000000C001
10000000C0000000C0000000C0000000C001
10000000C000CCCCC000CCCCC0000000C001
100000000000000000000000000000000001
111111111111111111111111111111111111