11111111111111111111111111111111111111
10C00000000000000000000000000000000001
10C000000000000000000000C0000000000001
1011011C111101001011011010101C10111001
100000000000000000C0000000000000000001
1000000000C000000000000000000000000001
10111110111101001011111011101010111001
101C1010100101CC10101010101C1010100101
10101010111101111010101010101010100101
101010101CC101001010101010101E10100101
10101010100101001010101011101110111001
10000000000000000000000000000000000001
100000P0000000C0C00000C000000000000001
11111111111111111111111111111111111111