1111111111111111111111
1C10001011101110100011
1000000P00000000001111
1011101011101010111011
1000C00C101010000000E1
1111111111111111111111